FSOT 64-CODON TRINARY MAPPING
============================================================
CODON      | PRIMARY (A,G=+1, C,T=-1)  | SECONDARY (A=+1, T=-1, G,C=0)
------------------------------------------------------------
AAA        | [1, 1, 1]                 | [1, 1, 1]                
AAC        | [1, 1, -1]                | [1, 1, 0]                
AAG        | [1, 1, 1]                 | [1, 1, 0]                
AAT        | [1, 1, -1]                | [1, 1, -1]               
ACA        | [1, -1, 1]                | [1, 0, 1]                
ACC        | [1, -1, -1]               | [1, 0, 0]                
ACG        | [1, -1, 1]                | [1, 0, 0]                
ACT        | [1, -1, -1]               | [1, 0, -1]               
AGA        | [1, 1, 1]                 | [1, 0, 1]                
AGC        | [1, 1, -1]                | [1, 0, 0]                
AGG        | [1, 1, 1]                 | [1, 0, 0]                
AGT        | [1, 1, -1]                | [1, 0, -1]               
ATA        | [1, -1, 1]                | [1, -1, 1]               
ATC        | [1, -1, -1]               | [1, -1, 0]               
ATG        | [1, -1, 1]                | [1, -1, 0]               
ATT        | [1, -1, -1]               | [1, -1, -1]              
CAA        | [-1, 1, 1]                | [0, 1, 1]                
CAC        | [-1, 1, -1]               | [0, 1, 0]                
CAG        | [-1, 1, 1]                | [0, 1, 0]                
CAT        | [-1, 1, -1]               | [0, 1, -1]               
CCA        | [-1, -1, 1]               | [0, 0, 1]                
CCC        | [-1, -1, -1]              | [0, 0, 0]                
CCG        | [-1, -1, 1]               | [0, 0, 0]                
CCT        | [-1, -1, -1]              | [0, 0, -1]               
CGA        | [-1, 1, 1]                | [0, 0, 1]                
CGC        | [-1, 1, -1]               | [0, 0, 0]                
CGG        | [-1, 1, 1]                | [0, 0, 0]                
CGT        | [-1, 1, -1]               | [0, 0, -1]               
CTA        | [-1, -1, 1]               | [0, -1, 1]               
CTC        | [-1, -1, -1]              | [0, -1, 0]               
CTG        | [-1, -1, 1]               | [0, -1, 0]               
CTT        | [-1, -1, -1]              | [0, -1, -1]              
GAA        | [1, 1, 1]                 | [0, 1, 1]                
GAC        | [1, 1, -1]                | [0, 1, 0]                
GAG        | [1, 1, 1]                 | [0, 1, 0]                
GAT        | [1, 1, -1]                | [0, 1, -1]               
GCA        | [1, -1, 1]                | [0, 0, 1]                
GCC        | [1, -1, -1]               | [0, 0, 0]                
GCG        | [1, -1, 1]                | [0, 0, 0]                
GCT        | [1, -1, -1]               | [0, 0, -1]               
GGA        | [1, 1, 1]                 | [0, 0, 1]                
GGC        | [1, 1, -1]                | [0, 0, 0]                
GGG        | [1, 1, 1]                 | [0, 0, 0]                
GGT        | [1, 1, -1]                | [0, 0, -1]               
GTA        | [1, -1, 1]                | [0, -1, 1]               
GTC        | [1, -1, -1]               | [0, -1, 0]               
GTG        | [1, -1, 1]                | [0, -1, 0]               
GTT        | [1, -1, -1]               | [0, -1, -1]              
TAA        | [-1, 1, 1]                | [-1, 1, 1]               
TAC        | [-1, 1, -1]               | [-1, 1, 0]               
TAG        | [-1, 1, 1]                | [-1, 1, 0]               
TAT        | [-1, 1, -1]               | [-1, 1, -1]              
TCA        | [-1, -1, 1]               | [-1, 0, 1]               
TCC        | [-1, -1, -1]              | [-1, 0, 0]               
TCG        | [-1, -1, 1]               | [-1, 0, 0]               
TCT        | [-1, -1, -1]              | [-1, 0, -1]              
TGA        | [-1, 1, 1]                | [-1, 0, 1]               
TGC        | [-1, 1, -1]               | [-1, 0, 0]               
TGG        | [-1, 1, 1]                | [-1, 0, 0]               
TGT        | [-1, 1, -1]               | [-1, 0, -1]              
TTA        | [-1, -1, 1]               | [-1, -1, 1]              
TTC        | [-1, -1, -1]              | [-1, -1, 0]              
TTG        | [-1, -1, 1]               | [-1, -1, 0]              
TTT        | [-1, -1, -1]              | [-1, -1, -1]             
